AIM	AOL Instant Messenger
abc	already been chewed
abc	always be careful
abt	about
acc	account
adn	any day now
afaik	as far as I know
afk	away from keyboard
aitr	adult in the room
aka	also know as
alol	actual laugh out loud
anx	thanks
aoas	all of a sudden
argh	angry
asap	as soon as possible
asl	age, sex, location
atl	all time love
atm	at the moment
att	all the time
atw	at the weekend
au	as usual
aukm	are you kidding me
awol	absent without leave
ayfkm	are you friggin kidding me
aykm	are you kidding me
azn	asian
b	be
b&amp;w	black and white
b-day	birthday
b-p	sunglasses w/ tongue 
b/c	because
b/l	buddy list
b/w	between
b4	before
b4n	before now
baibai	bye bye
bb	baby
bb	bye bye
bbb	bye bye baby
bbfn	bye bye for now
bbiab	be back in a bit
bbl	be back later
bbn	bye bye now
bbs	be back soon
bc	because
bcnu	be seeing- you
bcoz	because
bcuz	because
bd	big deal
bf	boy friend
bff	best friend(s) forever
bff4life	best freind forever for life
bffae	best friend(s) forever and ever
bffl	best friend(s) for life
bfn	bye for now
bi	bye
bka	best known as
bl	belly laugh
bl	buddy list
bmg	be my guest
bmgwl	busting my gut with laughter
bnscd	but now something completely different
boc	but of course
boin	believe it or not
bot	robot
bout	about
brb	be right back
brs	back real soon
brt	be right there
bs	bull s***
bsc	basic
bsu	better shut up
btdt	been there, done that
btw	by the way
btwitiailwu	by the way I think I am in love with you
between
bubhye	bye bye
bubi	bye bye
bwl	bursting with laughter
byca	before you came along
bz	busy
c	see
c&amp;g	chuckle and grin
c2c	care to chat
cam	camera
cbb	cant be bothered
cbl	come back later
cbs	come back soon
cf	cell phone
ch	come here
chix	chicks
cico	coffee in, coffee out
cid	crying in disgrace
ck	sick
ckbk	click back
clu	cool like you
cm	call me
cmiiw	correct me if I-m wrong
cml	call me later
cmm	change(d) my mind
cn	can
cnp	continued (in my) next post
comp	computer
conv	conversation
convo	conversation
cos	because 
coz	because
cp	cell phone
cr	chat room
crbt	crying real big tears
ctc	care to chat
ctc	cut the crap
ctp	cutie pie
cts	change the subject
cu	see you
cuial	see you in another life
cul	catch you later
cul	cool
cul	see you later
cul8r	catch you later
cul8r	see you later
cuttl	crawling under the table laughing
cuz	because
cuz	cousin
cuzo	cousin
cuzsin	cousin
cwd	Chat Word Dictionary
cwfl	can-t win for losing
cwyl	chat with you later
cya	see you
cyl	call you later
cyl	see you later
cyl8r	see you later
cym	change your mind
d/ced	disconnected
d/l	download(ing)(ed)
d8	date
da	the
daiz	days
dal	dum a** loser
dat	that
datz	that-s
dc	dont come
dced	disconnected
ddm	dont disturb me
dere	there
dgac	dont give a care
dgt	dont go there
diff	different
diku	do I know you
dint	didn-t
dis	this
diy	do it yourself
diz	this
dk	don-t know
dltbbb	don-t let the bed bugs bite
dltm	don-t lie to me
dnd	do not disturb
dob	date of birth
dont	don-t
dqmot	don-t quote me on this
drlng	darling
dsmus	thats some messed up stuff
dtb	don-t text back
dtg	dance together
duct	did you see that
dunno	don-t know
duz	does
duznt	doesn-t
e1	everyone
ea	each
eg	evil grin
emd	eat my dust
emfbi	excuse me for butting in
emo	emotion
emsg	email message
enuff	enough
eof	end of file
eom	end of message
eot	end of thread
eotw	end of the world
er1	everyone
es	enough said
every1	everyone
evry	every
evry1	everyone
ez	easy
f2f	face to face
f9	fine
faffn	friends are friends for never
fanks	thanks
fc	fingers crossed
fcu	freaking cracking up
fem	feminine
ffs	for frick sake
fh	future husband
fine	5n
fing	thing
fk	french kiss
floor	laughing
fo:o	for our eyes only
focl	fell off chair laughing
foeo	for our eyes only
fomc	fell off my chair
fomclol	fell off my chair laughing out loud
fone	phone
fsr	for some reason
ftbomh	from the bottom of my heart
ftl	for the loss
ftw	for the win
fu	follow up
fubar	fowled up beyond recognition
fufl	feel unique for life
fwb	friend with benefits
fwiw	for what it-s worth
fx	effects
fya	for your amusement
fyeo	for your eyes only
fyi	for your information
g	gee
g	grin
g2cu	good to see you
g2g	got to go
g2gp	got to go pee
g-morning	good morning
g-night	good night
ga	go ahead
gal	get a life
gb	God bless
gbf	gay best friend
gd	good
gf	girl friend
gfak	go fly a kite
gfi	go for it
gfn	gone for now
gg	good game
ggn	gotta go now
ggp	gotta go pee
giaug	give it all you got
giayg	give it all you got
gimme	give me
giwist	gee I wish i-d said that
gj	good job
gjp	good job partner
gl	good luck
gm	good morning
gmab	give me a break
gmbo	giggling my butt off
gmta	great minds think alike
gn	good night
gn8	goodnight
gnstdltbbb	good night, sleep tight, don-t let the bed bugs bite
go	get out
go2	go to
goi	get over it
goia	get over it already
goin	going
gonna	going to
gooh	get out of here
gosta	got to
gotcha	got you
gr8	great
gr8fl	great for life
grgz	gorgeous
grrr	I-m so angry
gtaw	go take a walk
gtcu	glad to see you
gtfo	get the frick out
gtfoml	get the frick outtta my life
gtg	good to go
gtg	got to go
gtgemb	got to go eat my breakfast
gtgemd	got to go eat my dinner
gtgeml	got to go eat my lunch
gtl	get a life
gtld	get a life, dude 
gtsy	glad to see you
gud	good
HIM	Hotmail Instant Messenger
h&amp;k	hug and kiss
h/o	hold on
h2h	hard to hear
h8	hate
haak	how about a kiss
hadg	have a great day 
hafta	have to
hags	have a great summer
hand	have a nice day
hav2	have to
hax	hacks
hb	hurry back
hbs	hurry back soon
hbu	how about you
hc	holy cow
hduw2bb	hello do you want to be buddies?
he	hello everyone
hed	head
hf	have fun
hhhvf	ha ha ha very funny
hhis	hanging head in shame
hi	hello
hmu	hit me up
hmwrk	homework
holla	hello
hos	husband over shoulder
hru	how are you
hsx	hey sexy
htgelb	have to go eat lunch, bye
htrd	hard to recognize dude
hu	hurry up
hud	how you doing?
hus	husband
hw	homework
hw	how
ILU	I love you
IM	Instant Messenger
i&lt;3u	I love you
iae	in any event
ibu	I believe you
ibyp	I beg your pardon
ic	I see
icw	I can-t wait
id	I-d
idc	I dont care
idgad	I dont give a darn
idgaf	I dont give a frick
idgi	I don-t get it
idk	I don-t know
idt	I don-t think
idttu	I dont talk to you
idw2tai	I don-t want to talk about it
idy	I dare you
ifly	I forever love you
igp	I gotta pee
igtg	I got to go
ih2g	I have to go
ihu	I hate you
ihu	i hear u 
ijf	I just farted
ik	I know
iki	I knew it
iki	I know it
ikr	I know right
ikt	I know that
iku	I know you
ill	I-ll
ilu	I love you
ilu	iloveyou
ilu2	I love you too
ilum	I love you more
ilusfm	I love you so freaking much
ily	I love you
ily	I love you
ily2	I love you too
ilyh	I love you harder
im	I-m
imao	in my arrogant opinion
imho	in my humble opinion
imnsho	in my not so humble opinion
imo	in my opinion
in2hufe	I need to hold you forever
inet	internet
ino	I know
iono	I don-t know
iou	I owe you
iow	in other words
irdc	I really dont care 
irdk	I really dont know 
irl	in real life
isn	is an
itint	I think I know that
itz	it-s
itz	its
iukwim	if you know what I mean
iwalu	I will always love you
iwuwh	i wish you were here
iykwim	if you know what I mean
iyss	if you say so
JC	just chillin-
Jlu	Jesus loves you
j/a	just asking
j/k	joking
j/p	just playing
j/w	just wondering
j2luk	just to let you know
j2lun	just to let you know
j2lyk	just to let you know
j2lyn	just to let you know
j4g	just for giggles
j4g	just for grins
jam	just a minute
jas	just a second
jc	just chilling
jic	just in case
jj	just joking
jk	just kidding
jlt	just like that
jm	just messing
jmo	just my opinion
jrr	jumping round and round
jsi	just say it
jtluk	just to let you know
jtlun	just to let you know
jtlyk	just to let you know
jtlyn	just to let you know
jw	just wondering
jwj	jumping with joy
k	okay
k m 	kiss me
kewl	cool
kinda	kind of
kit	keep in touch
kjst	k just stop talking
kk	ok
kk	ok ok
kl	cool
kma	kiss my a**
kno	know
koc	kiss on cheek
kol	kiss on lips
koo	cool
kool	cool
kotc	kiss on the cheek
kotl	kiss on the lips
kwim	know what I mean
kwl	cool
l2s	laughing to self
l8	late
l8a	later
l8r	later
l8r g8r	later gator
lab	luke anthony boyle
lal	laugh a little
lasa	loser
lawl	(lol as a spoken word, the pronunciation of lol)
lbnol	laughing but not outloud
lbr	loser beyond repair
leet	elite hacker
lemme	let me
leta	later
lhm	Lord help me
lho	laughing (my) head off
lhs	lets have sex
lhu	Lord help us
lig	life is good
lis	life is short
liu	livin it up
lm	love me
lma	leave me alone
lmao	laughing my a** off
lmfao	laughing my fat a** off
lmfao	laughing my friggin a** off
lmirl	let-s meet in real life
lmk	let me know
lms	like my status 
lmso	laughing my socks off
lns	laughing non stop
lol	laugh out loud
lol	laugh out love
lol	laughing out loud
lol	lots of laughs
lol	lots of love
lolv	lots of love
lotza	lots of
lro	lets rock on
lshih	laughing so hard it hurts
lshilmsadmt	laughing so hard I lost my sombraro and dropped my taco
lshmbh	laughing so hard my belly hurts
ltns	long time no see
ltr	later
lts	laughing to self
luv	love
luv ya	love you
luva	lover
luwamh	love you with all of my heart
lvu	I love you
ly	love you
ly4e	love you forever
lyk	like
lyl	love you lots
lylab	love you like a brother
lylas	love you like a sister
m	am
m/b	my bad
m2f	more to follow
m8	mate
mayb l8ter	maybe later
mbn	must be nice
mdc	my dad calls
me2	me too
meanna	mean to
mfc	my friend calls
mgis	money growth info systems
mhib2u	my heart is belongs to you
mia	missing in action
min	minute
mks	makes
ml	more later
mmc	my mom calls
mne	meanie
mob	mobile
mos	mom over shoulder 
msg	message
mtf	more to follow
mtg	meeting
mttskg	multitasking
mttskr	multi-tasker
mual	missing you a lot
mv	music video
mwlb	made with love by
myob	mind your own business
myodb	mind your own darn business
mys	miss you so
n	and
n	in
n/c	no comment
n/m	not much
n/w	no way
n/y	not yet
n1	none
n2m	not too much
n2n	nice to know
n8	night
nadt	not a darn thing
nbd	no big deal
nbsb	no boyfriend since birth
nce1	nice one
ndbwy	nice doing business with you
ne	any
ne1	anyone
nec	not even close
nehow	anyhow
nemore	anymore
nething	anything
neway	anyway
newbie	novice
ngh	not gonna happen
ngsb	no girlfriend since birth
nh	nice hand
nhot	never heard of that
ni	no idea
nifoc	naked in front of computer
nimu	no I meant u 
nimy	no I meant you
nitm	not in the mood
nk	no kidding
nl	nose laugh
nm	never mind
nmjc	nothing much just chillin-
nn	non
no1	no one
non	now or never 
noob	newbie (novice)
np	no
np	no problem
np	not possible
npa	no permanent address
nrn	no reply necessary
nt	not
ntcu	nice to see you
nte	not that easy
ntmu	nice to meet you
nty	no thank you
nub	noob (in a condescending way)
nuffin	nothing
nutn	nothing
nuttn	nothing
nv	envy
nvm	never mind
nvng	nothing ventured, nothing gained
nvr	never
nw	network
nw	no way
ny	not yet
nyt	night
oc	of course
oic	oh, I see
oinyw	oh, I know you will
oj	orange juice
okc	oh..ok cool
ol	old lady
ol	online
om	old man
omfg	oh my friggin gosh
omg	oh my gosh
omgco	oh my gosh captain obvious
omigosh	oh my gosh
oob	out of body
ook	oh, okay
oom	out of mind
op	out of place
osm	awesome
oth	on the other hand
ott	over the top
ottomh	off the top of my head
outta	out of
pac	parents are coming
paw	parents are watching
pcm	please call me
pdnd	please do not disturb
pds	please don-t shoot
pfm	please forgive me
pic	picture
pj	private joke
plmk	please let me know
plos	parent looking over shoulder
pls	please
plz	please
pm	private message
pmp	pee(d) my pants
poahf	put on a happy face
poh	parents over head
pos	parent over shoulder
ppl	people
ppr	paper
prb	probably
prl	parents are listening
prob	problem
probly	probably
prolly	probably
pttmiab	please talk to me, I am bored
puter	computer
pwn	pawn
qsed	quick simple easy done
qt	cutie
ques	question
r	are
r2u	roses to you
rbay	right back at you
rem	remember
rgr	roger (as in roger that)
rlly	really
rm	room
rnt	aren-t
rofbnl	rolling on the floor but not laughing
rofl	rolling on the floor laughing
roflay	rolling on thefloor laughing at you
roflmao	rolling on the floor laughing my a** off
roflol	rolling on the floor laughing out loud
rofluts	rolling on the floor laughing, unable to speak
roflwtime	rolling on the floor laughing with tears in my eyes
rofmo	rolling on the floor making out
rotfl	rolling on the 
rotflol	rolling on the floor laughing out loud
rox	rocks
rt	real time
rtfm	read the friggin manual
rtm	read the manual
rtsm	read the stupid manual
rufre	are u free
rur	are you ready?
rut	are you there
rxmysx	rocks my socks
s	smile
s2pid	stupid
s^	(sup) what-s up
sa	smart a**
scoop	scoop
sds	sweet dreams
sec	second
sete	smiling ear to ear
sfl	sister for life
shid	slap(s)(ping)(ped) head in disgust
shsmh	sitting here shaking my head
si	sure is
sk8	skate
sk8ing	skating
skl	school
skool	school
slafomah	something like a fan or maybe a hater
slr	sorry late reply
sm	same
smf	so much fun
smh	shaking my head
smhof	set my heart on fire
smile	:-)
sn	screen name
snafu	situation normal: all fouled up
snert	snot nosed egotistical rude teenager
so	significant other
sol	s*** out of luck
some1	someone
sorta	sort of
sos	save our souls
sos	someones on my shoulder 
sot	short of/on time
sot	sticking out tongue
sotmg	short of/on time, must go
soz	sorry
spoz	suppose
spoz2	supposed to
spoz2b	supposed to be
sry	sorry
ss	so sorry
st	stop that
stbu	sucks to be you
stdng	studing
stfu	shut the frick up
sth	something
sto	sticking tongue out
str8	strait
sttgd	im so tired I think im gona die
stw	scared to watch
su	shut up
suakm	shut up and kiss me
sul	see you later
sup	what-s up
sux	sucks
swag	scientific wild a** guess
swak	sealed with a kiss
swl	screaming with laughter
sxy	sexy
sy	see ya
syah	sending you a hug
syak	sending you a kiss
sys	see you soon
syt	sweet young thing
t^t	tsk tsk
ta	thanks a lot
ta	thanks again
ta	to
tat	that
taw	take a walk
tbh	to be honest
tc	take care
tc4fu	too cool for you
tcfu	too cool for you
tcoy	take care of yourself
temme	tell me
tgif	Thank God it-s Friday
tgis	thank God it-s Saturday
thanx	thanks
thatz	that-s
thnx	thanks
tho	though
thx	thanks
tia	thanks in advance
tlc	tender loving care
tmb	tell me i-m beautiful
tmi	too much information
tml	text me later
tmp	tell me please
tnf	totally not funny
tnq	thank you
tnx	thanks
toy	thinking of you
tp	toilet paper
tt4n	ta ta for now
ttc	text the cell
ttfg	ta ta for good
ttfn	ta ta for now
ttly	totally
ttme	talk to me
ttp	talking to people
tttyt	ta ta to you too
ttultr	talk to you later 
ttyl	talk to you later
ttyn	talk to you never
ttys	talk to you soon
turt	take your time
twb4u	that was before you
tweenglish	a language of teenagers that only they can understand
tx	thanksFONT>
ty	thank you
tyt	take your time
tyvm	thank you very much
u	you
u 2	you too
u2	you too
u-d	you-d
uaa	you are an angel
ud	you-d
udk	you don-t know
ull	you-ll
unn	ur not nice
uno	you know
ur	you-re
ur	your
uraimadrm	You are always in my dream
urk	you rock
urs	yours
urself	yourself
uuyone	everyone
uwtf	you with the face
vid	video
vl	will
vmt	very many thanks
vn	voice note
vv	vice versa
w-end	weekend
w/	with
w/e	whatever
w/o	without
w2g	way to go
w8	wait
wadup	what-s up
wag	wild a** guess
wah	what
wanna	want to
wass^	what-s up
wassup	what-s up
wat	what
watcha	what are you
watteva	whatever
wau	who asked you
way	what about you
wayd	what are you doing
waz^	what-s up
wazzup	what-s up
wb	welcome back
wboc	welcome back on cam
wbu	what about you
wby	what bout you
wcul	will catch you later
wdp	well done partner
wdys	what did you say
wdywtta	what do you want to talk about
weg	wicked evil grin
wen	when
whatcha	what are you
whatz	what-s
whoz	who is
wid	with
wie	with immediate effect
wkend	weekend
wkf	well known fact
wlc	welcome
wnwu	what-s new with you
woc	welcome on cam
wos	wife over shoulder
wru	who are you
wt	what
wtc	what the crap
wtf	what the frick
wtg	way to go
wth	what the heck
wtmi	way too much information
wtr	what-s the rush?
wtrdoin	what are you doing
wubol	will you be on later
wubu2	what you been up 2
wubu2	what you been up to?
wud	what are you doing
wul2	what you listening to?
wum	why you mad
wut	what
wuteva	whatever
wuu2	what you up to
wuu2	what you up to?
wuwtb	what (do) you want to talk about
wuz	was
wwicu	when will I see you
wwtmi	way way to much info
wy	with you
xcuz	excuse
xlnt	excellent
xmas	Christmas 
xoxoxo	hugs and kises
xqz	excuse
xx	hug and kiss
xyz	examine your zipper
YIM	Yahoo Instant Messenger
y	why
y/o	years old
ya	you
yab	you are beautiful
yabbys	you are beautiful but you suck
yanno	you know?
yasvmw	you are so very much welcome
ybs	you-ll be sorry
ycttscy	you can-t take this serious, can you
ydk	you don-t know
yep	yes
yg	young gentleman
yg	young gentlemen
ygtbk	you-ve got to be kidding
yl	young lady
ym	young man
ymw	your most welcome
yo	hey
yo	hi
yolo	you only live once
yqw	your quite welcome
yr	year
yrs	years
yt	you there
yu	you
yuh	you
yup	yes
yup	yes understood proceed
yvw	you-re very welcome
yw	you-re welcome
ziojkicc	zipper is open just kidding I cant see
zzzzz	sleeping
*&lt;[:{)	Santa
:-|	ambivalent
O:-)	angelic
&gt; &gt; :-(	angry
:@	angry and swearing
__/__	applause
|-i	asleep
(::()::)	band aide
:D	big smile
:-{}	blowing a kiss
\-O	bored
:-C	bummed out
|c|	can of coke
|p|	can of pepsi
:( )	can-t stop talking
|*-*|	cassette tape
&lt;&gt;	clap
:*)	clowning
:-	crying
:--(	crying sadly
:--)	crying with joy
\_/7	cup (coffee/tea)
:-9	delicious, yummy
:-&gt;	devilish
;-&gt;	devilish wink
&quot;8*#	drunk
:*)	drunk
(//_-)	emo
d//_-b	emo with headset
:-6	exhausted, wiped out
&gt; &gt;&lt;&lt;*&gt;	fish/fishy
&gt;&gt; &gt;&gt;&lt;)))`&gt;	fish/fishy
_-_-_-_-(*)	flying tomato
:-&gt;*&lt;-:	french kiss
:(	frown
\~/	full glass
\_/	glass (drink)
&lt;3	heart
(((((name)))))	hug (cyber hug)
(( )):**	hugs and kisses
:-i	indifferent
:-)*(-:	kiss
XD	laughing
XO	laughing smily, mouth wide open
(Y)	liking
:-#	lips are sealed
d-_-b	listening to music
:~/	mixed up
:-O	mouth open (surprised)
(_)	mug (coffee)
@[_]~~	mug of hot coffee or tea
~~!!~~	no joke?
****	popcorn
&amp;&amp;&amp;&amp;	pretzels
&gt;:@	really angry and swearing
---/--@	rose
@--)--)(--	rose
:-(	sad
:C 	sad
:-@	screaming
8O	shocked
:O	shocked
O.O	shocked or suprised
:-)	smile
XO	smile
=)	smile 
:)	smiling face
:{}::	sneezing
:-P	sticking out tongue
:o 	surprised
:-&amp;	tongue tied
:-C 	unbelievable
:-\	undecided
;-)	wink
|-O	yawning
&amp;&amp;	and
**poof**	bye
*G*	giggle
..........	speechless
10Q	thank you
10qs	thanks
10sion	tension
10son	tension
2	to
2-9t	tonight
2c4skool	to cool for school
2c4u	to cool for you
2cul	to cool
2cute	too cute
2d4	to die for
2day	today
2getha	together
2gether	together
2gether4eva	together forever
2l8	too late
2moro	tomorrow
2morrow	tomorrow
2moz	tomorrow
2mrw	tomorrow
2nite	tonight
4	for
411	information
4e	forever
4eva	forever
4get	forget
4rm	from
4u2c	for you to see
4va	forever
4yeo	for your eyes only
59	fine
5n	fine
8	ate
911	emergency
9t	night
&lt;3	love (heart)
&lt;GRRR&gt;	I-m so angry
?	huh?
?	what?
?4u	question for you
?dmn?	what do you mean?
@	at
^5	high five
